2021-02-28_12:03:24,33,1,૧-આમલગુંડી,12652,13087,25739,1819,1145,2964,8.74,14.37,11.51,District Panchayat,Tapi
2021-02-28_12:03:24,33,2,૨-બાલંબા,10847,11410,22257,3323,3605,6928,31.59,30.63,31.12,District Panchayat,Tapi
2021-02-28_12:03:24,33,3,૩-ભીમપુરા,8734,9224,17958,1346,987,2333,10.70,15.41,12.99,District Panchayat,Tapi
2021-02-28_12:03:24,33,4,૪-બોરખડી,11729,12649,24378,2593,2086,4679,16.49,22.10,19.19,District Panchayat,Tapi
2021-02-28_12:03:24,33,5,૫-બોરદા,10404,10378,20782,1467,1101,2568,10.60,14.10,12.35,District Panchayat,Tapi
2021-02-28_12:03:24,33,6,૬-બુહારી,10945,11528,22473,1004,577,1581,5.00,9.17,7.03,District Panchayat,Tapi
2021-02-28_12:03:24,33,7,૭-ચાંપાવાડી,10671,11293,21964,2348,1788,4136,15.83,22.00,18.83,District Panchayat,Tapi
2021-02-28_12:03:24,33,8,૮-ચીમેર,9408,9431,18839,1166,903,2069,9.57,12.39,10.98,District Panchayat,Tapi
2021-02-28_12:03:24,33,9,૯-ધજાંબા,8531,8916,17447,1046,655,1701,7.34,12.26,9.74,District Panchayat,Tapi
2021-02-28_12:03:24,33,10,૧૦-ડોલવણ,13529,13871,27400,1572,996,2568,7.18,11.61,9.37,District Panchayat,Tapi
2021-02-28_12:03:24,33,11,૧૧-ડોસવાડા,12391,12996,25387,1212,754,1966,5.80,9.78,7.74,District Panchayat,Tapi
2021-02-28_12:03:24,33,12,૧૨-ફુલવાડી,11906,12250,24156,3693,3831,7524,31.27,31.01,31.14,District Panchayat,Tapi
2021-02-28_12:03:24,33,13,૧૩-ગડત,11446,11763,23209,1152,691,1843,5.87,10.06,7.94,District Panchayat,Tapi
2021-02-28_12:03:24,33,14,૧૪-ગુણસદા,13518,14174,27692,1957,1474,3431,10.39,14.47,12.38,District Panchayat,Tapi
2021-02-28_12:03:24,33,15,૧૫-કમાલછોડ,10668,11244,21912,1237,670,1907,5.95,11.59,8.70,District Panchayat,Tapi
2021-02-28_12:03:24,33,16,૧૬-કરંજવેલ,10187,10801,20988,2628,1788,4416,16.55,25.79,21.04,District Panchayat,Tapi
2021-02-28_12:03:24,33,17,૧૭-કેળકુઇ,10568,11248,21816,2587,1977,4564,17.57,24.47,20.92,District Panchayat,Tapi
2021-02-28_12:03:24,33,18,૧૮-મોહિની,12819,13293,26112,4745,5130,9875,38.59,37.01,37.81,District Panchayat,Tapi
2021-02-28_12:03:24,33,19,૧૯-નિઝર,10609,10844,21453,2851,2655,5506,24.48,26.87,25.66,District Panchayat,Tapi
2021-02-28_12:03:24,33,20,૨૦-પાટી,11646,12276,23922,1485,923,2408,7.51,12.75,10.06,District Panchayat,Tapi
2021-02-28_12:03:24,33,21,૨૧-શાલે,8460,8387,16847,3239,3062,6301,36.50,38.28,37.40,District Panchayat,Tapi
2021-02-28_12:03:24,33,22,૨૨-ઉચ્છલ,10620,11278,21898,3449,3525,6974,31.25,32.47,31.84,District Panchayat,Tapi
2021-02-28_12:03:24,33,23,૨૩-ઉંચામાળા,11075,11393,22468,2553,1873,4426,16.43,23.05,19.69,District Panchayat,Tapi
2021-02-28_12:03:24,33,24,૨૪-વડપાડાનેસુ,12679,13386,26065,3898,4128,8026,30.83,30.74,30.79,District Panchayat,Tapi
2021-02-28_12:03:24,33,25,૨૫-વાલોડ,11419,12159,23578,971,582,1553,4.78,8.50,6.58,District Panchayat,Tapi
2021-02-28_12:03:24,33,26,૨૬-વેલદા,9133,9548,18681,2671,2819,5490,29.52,29.24,29.38,District Panchayat,Tapi
2021-02-28_12:03:24,205,1,૧-ભીલજાંબોલી,1928,2029,3957,514,539,1053,26.56,26.65,26.61,Taluka Panchayat,Nizar
2021-02-28_12:03:24,205,2,૨-બોરદા,1431,1551,2982,336,420,756,27.07,23.48,25.35,Taluka Panchayat,Nizar
2021-02-28_12:03:24,205,3,૩-હરદુલીદિગર,0,0,0,0,0,0,0.00,0.00,0.00,Taluka Panchayat,Nizar
2021-02-28_12:03:24,205,4,૪-ખોડદા,1441,1516,2957,363,402,765,26.51,25.19,25.87,Taluka Panchayat,Nizar
2021-02-28_12:03:24,205,5,૫-કોઠલીબુદ્રક,1571,1634,3205,450,399,849,24.41,28.64,26.48,Taluka Panchayat,Nizar
2021-02-28_12:03:24,205,6,૬-લક્ષ્મીખેડા,1457,1440,2897,552,594,1146,41.25,37.88,39.55,Taluka Panchayat,Nizar
2021-02-28_12:03:24,205,7,૭-નિઝર-૧,1792,1745,3537,407,366,773,20.97,22.71,21.85,Taluka Panchayat,Nizar
2021-02-28_12:03:24,205,8,૮-નિઝર-૨,1258,1365,2623,347,332,679,24.32,27.58,25.88,Taluka Panchayat,Nizar
2021-02-28_12:03:24,205,9,૯-રાયગઢ-૧,1676,1653,3329,720,689,1409,41.68,42.95,42.32,Taluka Panchayat,Nizar
2021-02-28_12:03:24,205,10,૧૦-રાયગઢ-૨,1514,1479,2993,689,684,1373,46.24,45.50,45.87,Taluka Panchayat,Nizar
2021-02-28_12:03:24,205,11,૧૧-સરવાળા,1911,1955,3866,553,480,1033,24.55,28.93,26.72,Taluka Panchayat,Nizar
2021-02-28_12:03:24,205,12,૧૨-શાલે-૧,2415,2453,4868,771,753,1524,30.69,31.92,31.30,Taluka Panchayat,Nizar
2021-02-28_12:03:24,205,13,૧૩-શાલે-૨,2855,2802,5657,1059,936,1995,33.40,37.09,35.26,Taluka Panchayat,Nizar
2021-02-28_12:03:24,205,14,૧૪-વેલદા-૧,1484,1563,3047,486,525,1011,33.58,32.74,33.18,Taluka Panchayat,Nizar
2021-02-28_12:03:24,205,15,૧૫-વેલદા-૨,1392,1449,2841,420,339,759,23.39,30.17,26.71,Taluka Panchayat,Nizar
2021-02-28_12:03:24,205,16,૧૬-વ્યાવલ,1883,1917,3800,536,561,1097,29.26,28.46,28.86,Taluka Panchayat,Nizar
2021-02-28_12:03:24,206,1,૧-આનંદપુર,2414,2491,4905,860,789,1649,31.67,35.62,33.61,Taluka Panchayat,Uchchhal
2021-02-28_12:03:24,206,2,૨-ભડભુંજા,2247,2383,4630,839,840,1679,35.24,37.33,36.26,Taluka Panchayat,Uchchhal
2021-02-28_12:03:24,206,3,૩-ભીંતબુદ્રક,2708,2854,5562,635,622,1257,21.79,23.44,22.59,Taluka Panchayat,Uchchhal
2021-02-28_12:03:24,206,4,૪-ભીંતખુર્દ,2248,2341,4589,790,774,1564,33.06,35.14,34.08,Taluka Panchayat,Uchchhal
2021-02-28_12:03:24,206,5,૫-ચીખલી,2843,2979,5822,886,1019,1905,34.20,31.16,32.72,Taluka Panchayat,Uchchhal
2021-02-28_12:03:24,206,6,૬-કરોડ,2499,2530,5029,813,880,1693,34.78,32.53,33.66,Taluka Panchayat,Uchchhal
2021-02-28_12:03:24,206,7,૭-કટાસવાણ,2178,2349,4527,754,739,1493,31.46,34.61,32.97,Taluka Panchayat,Uchchhal
2021-02-28_12:03:24,206,8,૮-ખાબદા,2067,2218,4285,708,793,1501,35.75,34.25,35.02,Taluka Panchayat,Uchchhal
2021-02-28_12:03:24,206,9,૯-મીરકોટ,2253,2424,4677,523,622,1145,25.66,23.21,24.48,Taluka Panchayat,Uchchhal
2021-02-28_12:03:24,206,10,૧૦-મોગરણ,1747,1833,3580,627,699,1326,38.13,35.89,37.03,Taluka Panchayat,Uchchhal
2021-02-28_12:03:24,206,11,૧૧-મોહિની-૧,1881,1931,3812,800,847,1647,43.86,42.53,43.20,Taluka Panchayat,Uchchhal
2021-02-28_12:03:24,206,12,૧૨-મોહિની-૨,1825,1857,3682,696,800,1496,43.08,38.13,40.63,Taluka Panchayat,Uchchhal
2021-02-28_12:03:24,206,13,૧૩-પાટીબંધારા,2669,2829,5498,997,1000,1997,35.34,37.35,36.32,Taluka Panchayat,Uchchhal
2021-02-28_12:03:24,206,14,૧૪-સેવટી,2198,2313,4511,812,904,1716,39.08,36.94,38.04,Taluka Panchayat,Uchchhal
2021-02-28_12:03:24,206,15,૧૫-ઉચ્છલ,1528,1631,3159,473,535,1008,32.80,30.95,31.90,Taluka Panchayat,Uchchhal
2021-02-28_12:03:24,206,16,૧૬-વડપાડાનેસુ,2813,2994,5807,879,920,1799,30.72,31.24,30.97,Taluka Panchayat,Uchchhal
2021-02-28_12:03:24,207,1,૧-બાલપુર,2656,2817,5473,568,311,879,11.04,21.38,16.06,Taluka Panchayat,Vyara
2021-02-28_12:03:24,207,2,૨-બેડકુવાદુર,2769,2864,5633,798,673,1471,23.49,28.81,26.11,Taluka Panchayat,Vyara
2021-02-28_12:03:24,207,3,૩-બોરખડી,2740,2914,5654,567,446,1013,15.30,20.69,17.91,Taluka Panchayat,Vyara
2021-02-28_12:03:24,207,4,૪-ચાંપાવાડી,2758,3021,5779,788,573,1361,18.96,28.57,23.55,Taluka Panchayat,Vyara
2021-02-28_12:03:24,207,5,૫-ઘાટ,2799,2962,5761,648,499,1147,16.84,23.15,19.90,Taluka Panchayat,Vyara
2021-02-28_12:03:24,207,6,૬-ડોલારા,2740,2852,5592,694,384,1078,13.46,25.32,19.27,Taluka Panchayat,Vyara
2021-02-28_12:03:24,207,7,૭-ઘાટા,2957,3094,6051,596,425,1021,13.73,20.15,16.87,Taluka Panchayat,Vyara
2021-02-28_12:03:24,207,8,૮-ઝાંખરી,2328,2469,4797,665,507,1172,20.53,28.56,24.43,Taluka Panchayat,Vyara
2021-02-28_12:03:24,207,9,૯-કાનપુરા,2791,2874,5665,474,379,853,13.18,16.98,15.05,Taluka Panchayat,Vyara
2021-02-28_12:03:24,207,10,૧૦-કપુરા,3071,3325,6396,621,476,1097,14.31,20.22,17.15,Taluka Panchayat,Vyara
2021-02-28_12:03:24,207,11,૧૧-કરંજવેલ,2463,2663,5126,701,586,1287,22.00,28.46,25.10,Taluka Panchayat,Vyara
2021-02-28_12:03:24,207,12,૧૨-કસવાવ,2594,2683,5277,540,394,934,14.68,20.81,17.69,Taluka Panchayat,Vyara
2021-02-28_12:03:24,207,13,૧૩-કટાસવાણ,2830,3061,5891,677,471,1148,15.38,23.92,19.48,Taluka Panchayat,Vyara
2021-02-28_12:03:24,207,14,૧૪-કેળકુઇ,2373,2548,4921,693,543,1236,21.31,29.20,25.11,Taluka Panchayat,Vyara
2021-02-28_12:03:24,207,15,૧૫-ખુશાલપુરા,3088,3349,6437,728,673,1401,20.09,23.57,21.76,Taluka Panchayat,Vyara
2021-02-28_12:03:24,207,16,૧૬-મગરકુઇ,2802,3055,5857,706,541,1247,17.70,25.19,21.29,Taluka Panchayat,Vyara
2021-02-28_12:03:24,207,17,૧૭-પાનવાડી,2609,2777,5386,523,412,935,14.83,20.04,17.35,Taluka Panchayat,Vyara
2021-02-28_12:03:24,207,18,૧૮-તાડકુવા,2513,2621,5134,563,424,987,16.17,22.40,19.22,Taluka Panchayat,Vyara
2021-02-28_12:03:24,207,19,૧૯-ઉંચામાળા-૧,2832,2972,5804,681,385,1066,12.95,24.04,18.36,Taluka Panchayat,Vyara
2021-02-28_12:03:24,207,20,૨૦-ઉંચામાળા-૨,2517,2463,4980,478,390,868,15.83,18.99,17.42,Taluka Panchayat,Vyara
2021-02-28_12:03:24,208,1,૧-અલગટ,1938,1964,3902,492,416,908,21.18,25.38,23.27,Taluka Panchayat,Valod
2021-02-28_12:03:24,208,2,૨-અંધાત્રી,2451,2538,4989,630,548,1178,21.59,25.70,23.61,Taluka Panchayat,Valod
2021-02-28_12:03:24,208,3,૩-બેડકુવા,2329,2456,4785,752,580,1332,23.61,32.28,27.83,Taluka Panchayat,Valod
2021-02-28_12:03:24,208,4,૪-બુહારી,2123,2113,4236,626,446,1072,21.10,29.48,25.30,Taluka Panchayat,Valod
2021-02-28_12:03:24,208,5,૫-દેગામા,2105,2283,4388,636,469,1105,20.54,30.21,25.18,Taluka Panchayat,Valod
2021-02-28_12:03:24,208,6,૬-ગોલણ,1992,2275,4267,550,578,1128,25.40,27.61,26.43,Taluka Panchayat,Valod
2021-02-28_12:03:24,208,7,૭-કલમકુઇ,1861,1990,3851,413,339,752,17.03,22.19,19.52,Taluka Panchayat,Valod
2021-02-28_12:03:24,208,8,૮-કમાલછોડ,2438,2429,4867,726,613,1339,25.23,29.77,27.51,Taluka Panchayat,Valod
2021-02-28_12:03:24,208,9,૯-મોરદેવી,2441,2638,5079,749,531,1280,20.12,30.68,25.20,Taluka Panchayat,Valod
2021-02-28_12:03:24,208,10,૧૦-રાનવેરી,2052,2254,4306,607,465,1072,20.62,29.58,24.89,Taluka Panchayat,Valod
2021-02-28_12:03:24,208,11,૧૧-શીકેર,2033,2149,4182,675,581,1256,27.03,33.20,30.03,Taluka Panchayat,Valod
2021-02-28_12:03:24,208,12,૧૨-સ્યાદલા,1935,2086,4021,654,505,1159,24.20,33.79,28.82,Taluka Panchayat,Valod
2021-02-28_12:03:24,208,13,૧૩-વાલોડ-૧,1701,1853,3554,388,274,662,14.78,22.81,18.62,Taluka Panchayat,Valod
2021-02-28_12:03:24,208,14,૧૪-વાલોડ-૨,2022,2055,4077,513,471,984,22.91,25.37,24.13,Taluka Panchayat,Valod
2021-02-28_12:03:24,208,15,૧૫-વાલોડ-૩,1650,1677,3327,449,345,794,20.57,27.21,23.86,Taluka Panchayat,Valod
2021-02-28_12:03:24,208,16,૧૬-વેડછી,1961,2171,4132,510,443,953,20.40,26.00,23.06,Taluka Panchayat,Valod
2021-02-28_12:03:24,209,1,૧-અંતાપુર,2305,2373,4678,847,677,1524,28.52,36.74,32.57,Taluka Panchayat,Dolvan
2021-02-28_12:03:24,209,2,૨-બામણામાળદુર,2622,2824,5446,725,615,1340,21.77,27.65,24.60,Taluka Panchayat,Dolvan
2021-02-28_12:03:24,209,3,૩-બેડારાયપુરા,2147,2182,4329,665,552,1217,25.29,30.97,28.11,Taluka Panchayat,Dolvan
2021-02-28_12:03:24,209,4,૪-બેડચીત,2593,2614,5207,225,147,372,5.62,8.67,7.14,Taluka Panchayat,Dolvan
2021-02-28_12:03:24,209,5,૫-ચુનાવાડી,2346,2398,4744,285,189,474,7.88,12.14,9.99,Taluka Panchayat,Dolvan
2021-02-28_12:03:24,209,6,૬-ડોલવણ,2835,2888,5723,367,243,610,8.41,12.94,10.65,Taluka Panchayat,Dolvan
2021-02-28_12:03:24,209,7,૭-ગડત,2290,2379,4669,234,128,362,5.38,10.21,7.75,Taluka Panchayat,Dolvan
2021-02-28_12:03:24,209,8,૮-કાકડવા,1972,2023,3995,219,104,323,5.14,11.10,8.08,Taluka Panchayat,Dolvan
2021-02-28_12:03:24,209,9,૯-કલકવા,1995,2024,4019,164,96,260,4.74,8.22,6.46,Taluka Panchayat,Dolvan
2021-02-28_12:03:24,209,10,૧૦-કરંજખેડ,2129,2162,4291,217,141,358,6.52,10.19,8.34,Taluka Panchayat,Dolvan
2021-02-28_12:03:24,209,11,૧૧-પાટી,2027,2200,4227,268,204,472,9.27,13.22,11.16,Taluka Panchayat,Dolvan
2021-02-28_12:03:24,209,12,૧૨-પીપલવાડા,2465,2589,5054,393,236,629,9.11,15.94,12.44,Taluka Panchayat,Dolvan
2021-02-28_12:03:24,209,13,૧૩-પીઠાદરા,2227,2290,4517,259,151,410,6.59,11.62,9.07,Taluka Panchayat,Dolvan
2021-02-28_12:03:24,209,14,૧૪-તાકીઆંબા,2212,2327,4539,234,168,402,7.21,10.57,8.85,Taluka Panchayat,Dolvan
2021-02-28_12:03:24,209,15,૧૫-ઉમરવાવદુર,2035,2073,4108,250,151,401,7.28,12.28,9.76,Taluka Panchayat,Dolvan
2021-02-28_12:03:24,209,16,૧૬-ઉમરવાવનજીક,2421,2564,4985,236,151,387,5.88,9.74,7.76,Taluka Panchayat,Dolvan
2021-02-28_12:03:24,210,1,૧-બહુરૂપા,1850,1939,3789,609,625,1234,32.23,32.91,32.56,Taluka Panchayat,Kukarmunda
2021-02-28_12:03:24,210,2,૨-બાલદા,1519,1484,3003,465,359,824,24.19,30.61,27.43,Taluka Panchayat,Kukarmunda
2021-02-28_12:03:24,210,3,૩-બાલંબા,1168,1195,2363,248,329,577,27.53,21.23,24.41,Taluka Panchayat,Kukarmunda
2021-02-28_12:03:24,210,4,૪-ચોખીઆમલી,1526,1616,3142,457,482,939,29.82,29.94,29.88,Taluka Panchayat,Kukarmunda
2021-02-28_12:03:24,210,5,૫-ડાબરીઆંબા(ગંગથા),1572,1613,3185,505,458,963,28.39,32.12,30.23,Taluka Panchayat,Kukarmunda
2021-02-28_12:03:24,210,6,૬-ફુલવાડી-૧,1517,1487,3004,415,298,713,20.04,27.35,23.73,Taluka Panchayat,Kukarmunda
2021-02-28_12:03:24,210,7,૭-ફુલવાડી-૨,866,883,1749,201,213,414,24.12,23.21,23.67,Taluka Panchayat,Kukarmunda
2021-02-28_12:03:24,210,8,૮-ફુલવાડી-૩,1076,1185,2261,309,444,753,37.46,28.71,33.30,Taluka Panchayat,Kukarmunda
2021-02-28_12:03:24,210,9,૯-ફુલવાડી-૪,1361,1498,2859,398,522,920,34.84,29.24,32.17,Taluka Panchayat,Kukarmunda
2021-02-28_12:03:24,210,10,૧૦-ઇટવાઇ,1380,1515,2895,444,525,969,34.65,32.17,33.47,Taluka Panchayat,Kukarmunda
2021-02-28_12:03:24,210,11,૧૧-કેવડામોઇ,1826,1854,3680,596,643,1239,34.68,32.63,33.66,Taluka Panchayat,Kukarmunda
2021-02-28_12:03:24,210,12,૧૨-મટાવલ,1612,1694,3306,622,676,1298,39.90,38.58,39.26,Taluka Panchayat,Kukarmunda
2021-02-28_12:03:24,210,13,૧૩-મોરંબા,1694,1805,3499,661,689,1350,38.17,39.02,38.58,Taluka Panchayat,Kukarmunda
2021-02-28_12:03:24,210,14,૧૪-પીશાવર,0,0,0,0,0,0,0.00,0.00,0.00,Taluka Panchayat,Kukarmunda
2021-02-28_12:03:24,210,15,૧૫-રાજપુર,1681,1812,3493,412,479,891,26.43,24.50,25.50,Taluka Panchayat,Kukarmunda
2021-02-28_12:03:24,210,16,૧૬-સદગવાણ,1128,1120,2248,342,395,737,35.26,30.31,32.78,Taluka Panchayat,Kukarmunda
2021-02-28_12:03:24,234,1,૧-આમલગુંડી,3513,3591,7104,340,203,543,5.65,9.67,7.64,Taluka Panchayat,Songadh
2021-02-28_12:03:24,234,2,૨-ભીમપુરા,2847,2981,5828,469,318,787,10.66,16.47,13.50,Taluka Panchayat,Songadh
2021-02-28_12:03:24,234,3,૩-બોરદા,3643,3701,7344,526,482,1008,13.02,14.43,13.72,Taluka Panchayat,Songadh
2021-02-28_12:03:24,234,4,૪-ચીમેર,0,0,0,0,0,0,0.00,0.00,0.00,Taluka Panchayat,Songadh
2021-02-28_12:03:24,234,5,૫-ચીમકુવા,2862,3040,5902,450,276,726,9.07,15.72,12.30,Taluka Panchayat,Songadh
2021-02-28_12:03:24,234,6,૬-ધજાંબા,2611,2788,5399,362,206,568,7.38,13.86,10.52,Taluka Panchayat,Songadh
2021-02-28_12:03:24,234,7,૭-ધમોડી,3216,3406,6622,359,257,616,7.54,11.16,9.30,Taluka Panchayat,Songadh
2021-02-28_12:03:24,234,8,૮-ડોસવાડા,3137,3268,6405,227,135,362,4.13,7.23,5.65,Taluka Panchayat,Songadh
2021-02-28_12:03:24,234,9,૯-ગોપાલપુરા,2865,3032,5897,534,362,896,11.93,18.63,15.19,Taluka Panchayat,Songadh
2021-02-28_12:03:24,234,10,૧૦-ગુણસદા,4355,4499,8854,700,633,1333,14.06,16.07,15.05,Taluka Panchayat,Songadh
2021-02-28_12:03:24,234,11,૧૧-હીરાવાડી,3226,3358,6584,483,248,731,7.38,14.97,11.10,Taluka Panchayat,Songadh
2021-02-28_12:03:24,234,12,૧૨-ખાંજર,2921,3091,6012,293,169,462,5.46,10.03,7.68,Taluka Panchayat,Songadh
2021-02-28_12:03:24,234,13,૧૩-ખેરવાડા,2382,2250,4632,359,215,574,9.55,15.07,12.39,Taluka Panchayat,Songadh
2021-02-28_12:03:24,234,14,૧૪-કીકાકુઈ,3117,3231,6348,333,193,526,5.97,10.68,8.28,Taluka Panchayat,Songadh
2021-02-28_12:03:24,234,15,૧૫-લીંબી,4379,4427,8806,582,414,996,9.35,13.29,11.31,Taluka Panchayat,Songadh
2021-02-28_12:03:24,234,16,૧૬-મલંગદેવ,3545,3471,7016,513,359,872,10.34,14.47,12.42,Taluka Panchayat,Songadh
2021-02-28_12:03:24,234,17,૧૭-મોંઘવાણ,3048,3106,6154,462,332,794,10.68,15.15,12.90,Taluka Panchayat,Songadh
2021-02-28_12:03:24,234,18,૧૮-પીપળકુવા,2644,2868,5512,301,263,564,9.17,11.38,10.23,Taluka Panchayat,Songadh
2021-02-28_12:03:24,234,19,૧૯-સીસોર,2924,2943,5867,268,143,411,4.85,9.16,7.00,Taluka Panchayat,Songadh
2021-02-28_12:03:24,234,20,૨૦-ટાપરવાડા,2907,3007,5914,190,143,333,4.75,6.53,5.63,Taluka Panchayat,Songadh
2021-02-28_12:03:24,234,21,૨૧-ટોકરવા,3185,3436,6621,421,329,750,9.57,13.21,11.32,Taluka Panchayat,Songadh
2021-02-28_12:03:24,234,22,૨૨-ઉખલદા,3116,3199,6315,386,236,622,7.37,12.38,9.84,Taluka Panchayat,Songadh
2021-02-28_12:03:24,234,23,૨૩-વાડીભેંસરોટ,3243,3375,6618,576,406,982,12.02,17.76,14.83,Taluka Panchayat,Songadh
2021-02-28_12:03:24,234,24,૨૪-વાઝરડા,2996,3185,6181,419,255,674,8.00,13.98,10.90,Taluka Panchayat,Songadh
2021-02-28_12:03:24,44,1,વોર્ડ-1,2069,2168,4237,487,548,1035,25.27,23.53,24.42,Nagarpalika,Vyara
2021-02-28_12:03:24,44,2,વોર્ડ-2,2244,2229,4473,736,596,1332,26.73,32.79,29.77,Nagarpalika,Vyara
2021-02-28_12:03:24,44,3,વોર્ડ-3,2625,2603,5228,616,524,1140,20.13,23.46,21.80,Nagarpalika,Vyara
2021-02-28_12:03:24,44,4,વોર્ડ-4,2379,2561,4940,485,370,855,14.44,20.38,17.30,Nagarpalika,Vyara
2021-02-28_12:03:24,44,5,વોર્ડ-5,1950,1947,3897,537,536,1073,27.52,27.53,27.53,Nagarpalika,Vyara
2021-02-28_12:03:24,44,6,વોર્ડ-6,2502,2560,5062,676,581,1257,22.69,27.01,24.83,Nagarpalika,Vyara
2021-02-28_12:03:24,44,7,વોર્ડ-7,2437,2403,4840,576,488,1064,20.30,23.63,21.98,Nagarpalika,Vyara
